WWWWWWWWWWWWWWW
W           B W
W  BBBBBBBBB BW
W BB   B   BB W
W B B  B  B B W
W B  B B B  B W
W B   B B   B W
W BBBB B BBBB W
W B   B B   B W
W B  B B B  B W
W B B  B  B B W
W BB   B   BB W
WB BBBBBBBBB BW
W B         B W
WWWWWWWWWWWWWWW
