WWWWWWWWWWWWWWW
W B  B   B  B W
WBWB BW WB BWBW
W BWB  W  BWB W
W  BW  B  WB  W
WBB    B    BBW
W W    W    W W
WB WBBWWWBBW  W
W W    W    W W
WBB    B    BBW
W  BW  B  WB  W
W BWB  W  BWB W
WBWB BW WB BWBW
W B  B   B  B W
WWWWWWWWWWWWWWW
